"ad" = (/obj/machinery/light/small,/turf/simulated/floor/lino,/area/space)
"ax" = (/obj/structure/coatrack,/obj/item/clothing/suit/storage/hooded/wintercoat,/turf/simulated/floor/carpet/purple,/area/space)
"aC" = (/obj/machinery/light/small{dir = 1},/turf/unsimulated/floor{icon = 'icons/turf/snow.dmi'; icon_state = "snowwhite"},/area/space)
"aG" = (/obj/structure/table/gamblingtable,/obj/effect/floor_decal/spline/fancy/wood,/obj/structure/flora/pottedplant/smallcactus{pixel_y = 14},/turf/simulated/floor/wood/yew,/area/space)
"aN" = (/turf/simulated/floor/tiled/white,/area/space)
"aZ" = (/obj/machinery/space_heater,/turf/simulated/floor/tiled/techfloor,/area/space)
"bc" = (/turf/simulated/floor/tiled/freezer,/area/space)
"by" = (/obj/structure/table/gamblingtable,/obj/item/deck/cards,/turf/simulated/floor/wood/yew,/area/space)
"bV" = (/obj/structure/table/marble,/obj/effect/floor_decal/spline/fancy/wood{dir = 8},/turf/simulated/floor/lino,/area/space)
"cb" = (/obj/machinery/door/unpowered/simple/wood,/turf/simulated/floor/carpet/purple,/area/space)
"cy" = (/obj/effect/wallframe_spawn/no_grille,/turf/unsimulated/floor{icon_state = "plating"; name = "plating"},/area/space)
"cL" = (/obj/machinery/power/apc{dir = 1; name = "north bump"; pixel_y = 24},/obj/structure/cable/yellow{d2 = 8; icon_state = "0-8"},/turf/simulated/floor/wood,/area/space)
"dg" = (/obj/structure/flora/tree/dead,/turf/unsimulated/floor{icon = 'icons/turf/snow.dmi'; icon_state = "snowwhite"},/area/space)
"dR" = (/obj/effect/floor_decal/snow,/turf/unsimulated/floor{icon = 'icons/turf/snow.dmi'; icon_state = "snowplating"},/area/space)
"eI" = (/obj/machinery/light/small{dir = 4; pixel_y = 0},/turf/simulated/floor/wood,/area/space)
"fO" = (/obj/structure/closet/cabinet,/obj/item/clothing/suit/storage/toggle/gorka_jacket,/obj/item/clothing/suit/storage/toggle/gorka_jacket/milita,/obj/item/clothing/suit/storage/toggle/gorka_jacket/tan,/obj/item/crowbar/prybar,/obj/item/gun/energy/gun/small,/obj/item/clothing/head/cowboy_hat,/turf/simulated/floor/carpet,/area/space)
"gN" = (/obj/structure/closet/crate/freezer,/obj/item/reagent_containers/food/condiment/salt,/obj/item/pizzabox/vegetable,/obj/item/pizzabox/vegetable,/obj/item/storage/box/cola/icedtea,/obj/item/storage/box/cola/icedtea,/obj/item/storage/box/cola/icedtea,/obj/item/reagent_containers/glass/beaker/bowl,/obj/item/reagent_containers/food/condiment/enzyme,/turf/simulated/floor/tiled/freezer,/area/space)
"hx" = (/obj/structure/janitorialcart,/obj/item/mop,/obj/effect/floor_decal/industrial/outline/yellow,/obj/item/reagent_containers/spray/cleaner,/obj/item/grenade/chem_grenade/cleaner,/obj/machinery/light/small{dir = 8},/turf/unsimulated/floor{icon_state = "plating"; name = "plating"},/area/space)
"hz" = (/obj/effect/floor_decal/spline/fancy/wood{dir = 8},/turf/simulated/floor/wood/yew,/area/space)
"ik" = (/turf/simulated/floor/pool,/area/space)
"in" = (/obj/structure/cable/yellow{d1 = 1; d2 = 2; icon_state = "1-2"},/obj/structure/catwalk,/turf/unsimulated/floor{icon_state = "plating"; name = "plating"},/area/space)
"ix" = (/obj/structure/hygiene/drain/bath,/turf/simulated/floor/pool,/area/space)
"iC" = (/obj/effect/decal/cleanable/dirt,/turf/simulated/floor/wood,/area/space)
"jW" = (/obj/machinery/gibber,/turf/simulated/floor/tiled/freezer,/area/space)
"kv" = (/obj/structure/table/woodentable,/obj/random/drinkbottle{pixel_y = 10; pixel_x = 7},/turf/simulated/floor/wood,/area/space)
"ky" = (/obj/structure/bed/chair/comfy/purple{dir = 4},/turf/simulated/floor/carpet/purple,/area/space)
"lo" = (/obj/structure/table/woodentable,/obj/item/storage/box/donkpocket_premium,/obj/item/storage/box/glasses,/obj/effect/floor_decal/spline/fancy/wood{dir = 1},/obj/machinery/light/small{dir = 1},/turf/simulated/floor/wood/yew,/area/space)
"lu" = (/obj/structure/bed/chair/wood,/turf/simulated/floor/wood,/area/space)
"lO" = (/obj/structure/coatrack,/obj/item/clothing/suit/wizrobe/gentlecoat,/turf/simulated/floor/carpet/purple,/area/space)
"lT" = (/obj/item/beach_ball,/turf/simulated/floor/pool,/area/space)
"mt" = (/obj/structure/closet/cabinet,/obj/item/clothing/suit/storage/militaryjacket/white,/obj/item/clothing/suit/storage/militaryjacket/tan,/obj/item/clothing/suit/storage/toggle/brown_jacket,/obj/item/crowbar/prybar,/turf/simulated/floor/carpet,/area/space)
"nf" = (/obj/machinery/door/unpowered/simple/wood,/turf/simulated/floor/wood,/area/space)
"nX" = (/obj/item/stool/bar/padded,/obj/effect/floor_decal/spline/fancy/wood{dir = 8},/turf/simulated/floor/wood/yew,/area/space)
"pb" = (/obj/effect/wallframe_spawn/no_grille,/turf/simulated/floor/wood,/area/space)
"pl" = (/turf/simulated/floor/lino,/area/space)
"qd" = (/obj/structure/table/gamblingtable,/obj/item/gun/projectile/revolver/holdout,/turf/simulated/floor/carpet/purple,/area/space)
"sg" = (/obj/effect/floor_decal/spline/fancy/wood{dir = 4},/turf/simulated/floor/wood/yew,/area/space)
"si" = (/obj/structure/table/woodentable,/turf/simulated/floor/wood,/area/space)
"so" = (/obj/effect/decal/cleanable/dirt,/turf/simulated/floor/wood/yew,/area/space)
"sr" = (/obj/item/stool/bar/padded,/turf/simulated/floor/wood/yew,/area/space)
"sw" = (/obj/structure/table/gamblingtable,/obj/random/drinkbottle{pixel_y = 10; pixel_x = 7},/obj/random/drinkbottle{pixel_x = -3; pixel_y = 4},/turf/simulated/floor/wood/yew,/area/space)
"tR" = (/obj/machinery/power/terminal{dir = 8},/obj/structure/cable/yellow{d1 = 2; d2 = 8; icon_state = "2-8"},/obj/structure/cable/yellow{d2 = 8; icon_state = "0-8"},/obj/structure/catwalk,/turf/unsimulated/floor{icon_state = "plating"; name = "plating"},/area/space)
"ua" = (/obj/machinery/light/small,/turf/simulated/floor/tiled/freezer,/area/space)
"we" = (/obj/structure/closet/athletic_mixed,/turf/simulated/floor/tiled/white/monotile,/area/space)
"wg" = (/obj/machinery/door/unpowered/simple/wood,/obj/structure/cable/yellow{d1 = 1; d2 = 2; icon_state = "1-2"},/obj/structure/catwalk,/turf/unsimulated/floor{icon_state = "plating"; name = "plating"},/area/space)
"wr" = (/obj/machinery/light/small,/turf/simulated/floor/tiled/white/monotile,/area/space)
"xM" = (/obj/structure/coatrack,/obj/item/clothing/suit/leathercoat,/obj/machinery/light/small,/turf/simulated/floor/carpet/purple,/area/space)
"xN" = (/obj/machinery/door/unpowered/simple/wood,/turf/simulated/floor/tiled/white,/area/space)
"xU" = (/obj/effect/decal/cleanable/dirt,/turf/simulated/floor/lino,/area/space)
"ys" = (/obj/machinery/light/small{dir = 1},/turf/simulated/floor/wood,/area/space)
"yO" = (/obj/machinery/door/unpowered/simple/wood,/turf/simulated/floor/tiled/freezer,/area/space)
"zx" = (/obj/machinery/vending/boozeomat{dir = 4},/turf/simulated/floor/lino,/area/space)
"zz" = (/obj/structure/table/woodentable,/obj/machinery/microwave,/obj/effect/floor_decal/spline/fancy/wood{dir = 5; icon_state = "spline_fancy"},/turf/simulated/floor/wood/yew,/area/space)
"zD" = (/turf/simulated/floor/tiled/monotile,/area/space)
"zK" = (/obj/structure/flora/tree/pine,/turf/unsimulated/floor{icon = 'icons/turf/snow.dmi'; icon_state = "snowwhite"},/area/space)
"Ab" = (/obj/structure/closet/secure_closet/freezer/meat,/turf/simulated/floor/tiled/freezer,/area/space)
"Ay" = (/obj/effect/floor_decal/spline/fancy/wood{dir = 8},/obj/machinery/door/unpowered/simple/wood,/turf/simulated/floor/lino,/area/space)
"Bj" = (/obj/machinery/light/small,/turf/simulated/floor/wood,/area/space)
"BB" = (/obj/machinery/door/unpowered/simple/wood,/turf/simulated/floor/tiled,/area/space)
"BD" = (/obj/effect/floor_decal/spline/fancy/wood{dir = 8},/obj/effect/decal/cleanable/dirt,/turf/simulated/floor/wood/yew,/area/space)
"BZ" = (/turf/simulated/floor/wood/yew,/area/space)
"Cb" = (/obj/structure/table/marble,/obj/machinery/reagent_temperature,/obj/item/reagent_containers/food/drinks/shaker,/turf/simulated/floor/lino,/area/space)
"Ci" = (/turf/unsimulated/floor{icon = 'icons/turf/snow.dmi'; icon_state = "snowplating"},/area/space)
"Ck" = (/obj/structure/closet/secure_closet/freezer/fridge,/obj/item/storage/box/snack/candy,/obj/item/storage/box/snack/candy,/turf/simulated/floor/tiled/freezer,/area/space)
"Cz" = (/obj/machinery/light/small{dir = 1},/turf/simulated/floor/tiled/white/monotile,/area/space)
"Db" = (/obj/structure/flora/ausbushes/palebush,/turf/unsimulated/floor{icon = 'icons/turf/snow.dmi'; icon_state = "snowwhite"},/area/space)
"DB" = (/obj/structure/table/woodentable,/obj/machinery/chemical_dispenser/bar_soft/full,/obj/effect/floor_decal/spline/fancy/wood{dir = 9},/turf/simulated/floor/wood/yew,/area/space)
"DI" = (/obj/structure/table/marble,/obj/machinery/microwave,/turf/simulated/floor/lino,/area/space)
"DL" = (/obj/structure/coatrack,/obj/item/clothing/suit/greatcoat,/obj/machinery/light/small{dir = 1},/turf/simulated/floor/carpet/purple,/area/space)
"Ep" = (/obj/structure/bed/chair/wood{dir = 8},/turf/simulated/floor/wood,/area/space)
"EG" = (/obj/machinery/vending/sovietsoda,/obj/effect/floor_decal/spline/fancy/wood{dir = 1},/turf/simulated/floor/wood/yew,/area/space)
"Fd" = (/obj/structure/cable/yellow{d1 = 1; d2 = 4; icon_state = "1-4"},/obj/effect/decal/cleanable/dirt,/turf/simulated/floor/wood,/area/space)
"Fi" = (/obj/machinery/door/morgue{name = "Bath"},/turf/simulated/floor/wood/yew,/area/space)
"FF" = (/turf/simulated/floor/tiled,/area/space)
"FI" = (/obj/item/stool/bar/padded,/obj/effect/floor_decal/spline/fancy/wood,/obj/machinery/light/small,/turf/simulated/floor/wood/yew,/area/space)
"Gg" = (/obj/item/stool/bar/padded,/turf/simulated/floor/wood,/area/space)
"Gn" = (/turf/simulated/wall/wood,/area/space)
"GP" = (/obj/machinery/door/unpowered/simple/wood,/turf/unsimulated/floor{icon_state = "plating"; name = "plating"},/area/space)
"Hk" = (/obj/machinery/vending/fitness{dir = 8; pixel_x = 7},/turf/simulated/floor/tiled/monotile,/area/space)
"Hm" = (/obj/machinery/power/smes,/obj/structure/cable/yellow{d2 = 4; icon_state = "0-4"},/obj/structure/catwalk,/turf/unsimulated/floor{icon_state = "plating"; name = "plating"},/area/space)
"HE" = (/obj/structure/fitness/punchingbag,/turf/simulated/floor/wood,/area/space)
"Ih" = (/obj/structure/flora/pottedplant/minitree,/turf/simulated/floor/lino,/area/space)
"Is" = (/obj/structure/closet/toolcloset,/turf/simulated/floor/tiled/techfloor,/area/space)
"IA" = (/turf/unsimulated/floor{icon_state = "snow"},/area/space)
"IN" = (/obj/item/device/radio/intercom/syndicate{dir = 4; pixel_x = -22},/turf/simulated/floor/wood,/area/space)
"Kg" = (/obj/effect/floor_decal/snow,/turf/unsimulated/floor{icon = 'icons/turf/snow.dmi'; icon_state = "ice"},/area/space)
"KV" = (/turf/simulated/floor/carpet,/area/space)
"LC" = (/obj/machinery/door/unpowered/simple/wood,/turf/simulated/floor/carpet,/area/space)
"LK" = (/obj/effect/floor_decal/snow,/turf/unsimulated/floor{icon_state = "freezerfloor"},/area/space)
"Me" = (/obj/structure/bed/padded,/obj/item/bedsheet/hos,/obj/machinery/light/small{dir = 1},/turf/simulated/floor/carpet,/area/space)
"Mg" = (/turf/simulated/floor/wood,/area/space)
"Mv" = (/obj/effect/floor_decal/spline/fancy/wood{dir = 6; icon_state = "spline_fancy"},/turf/simulated/floor/wood/yew,/area/space)
"Mw" = (/obj/structure/table/woodentable,/obj/item/deck/cards,/turf/simulated/floor/wood,/area/space)
"MZ" = (/obj/structure/flora/pottedplant/orientaltree,/turf/simulated/floor/carpet,/area/space)
"Nd" = (/obj/structure/hygiene/faucet,/turf/simulated/floor/pool,/area/space)
"Nz" = (/obj/structure/window/reinforced,/turf/simulated/floor/wood,/area/space)
"NQ" = (/obj/structure/bed/chair/comfy/purple{dir = 1},/obj/machinery/light/small,/turf/simulated/floor/carpet/purple,/area/space)
"Ot" = (/obj/item/stool/bar/padded,/obj/effect/floor_decal/spline/fancy/wood{dir = 10},/turf/simulated/floor/wood/yew,/area/space)
"Ov" = (/obj/structure/table/marble,/obj/machinery/chemical_dispenser/bar_alc/full,/turf/simulated/floor/lino,/area/space)
"OH" = (/obj/machinery/light/small{dir = 4; pixel_y = 8},/turf/simulated/floor/tiled/monotile,/area/space)
"OS" = (/obj/structure/table/marble,/turf/simulated/floor/lino,/area/space)
"Pc" = (/obj/structure/bed/chair/padded/black{dir = 8},/turf/simulated/floor/lino,/area/space)
"Pd" = (/obj/structure/window/reinforced{dir = 4},/obj/structure/window/reinforced,/turf/simulated/floor/wood,/area/space)
"PO" = (/obj/structure/closet/cabinet,/obj/item/clothing/suit/storage/toggle/bomber,/obj/item/clothing/suit/storage/leather_jacket,/obj/item/clothing/suit/storage/militaryjacket,/obj/item/gun/projectile/pistol/holdout,/obj/item/crowbar/prybar,/turf/simulated/floor/carpet,/area/space)
"Qd" = (/obj/structure/closet/cabinet,/obj/item/clothing/suit/storage/militaryjacket/grey,/obj/item/clothing/suit/storage/militaryjacket/white,/obj/item/crowbar/prybar,/turf/simulated/floor/carpet,/area/space)
"Qv" = (/obj/structure/window/reinforced{dir = 4},/turf/simulated/floor/wood,/area/space)
"RH" = (/obj/machinery/space_heater,/turf/simulated/floor/carpet/purple,/area/space)
"Sy" = (/obj/machinery/light/small{dir = 8},/turf/simulated/floor/wood,/area/space)
"Tm" = (/obj/structure/bed/chair/comfy/purple,/turf/simulated/floor/carpet/purple,/area/space)
"Ug" = (/obj/machinery/light/small{dir = 4; pixel_y = 0},/turf/unsimulated/floor{icon = 'icons/turf/snow.dmi'; icon_state = "snowwhite"},/area/space)
"UH" = (/turf/unsimulated/floor{icon_state = "freezerfloor"},/area/space)
"Vn" = (/obj/machinery/power/port_gen/pacman{anchored = 1},/obj/item/stack/material/phoron/ten,/turf/simulated/floor/tiled/techfloor,/area/space)
"Wq" = (/turf/simulated/floor/tiled/white/monotile,/area/space)
"WU" = (/turf/unsimulated/floor{icon = 'icons/turf/snow.dmi'; icon_state = "snowwhite"},/area/space)
"XB" = (/obj/structure/bed/chair/comfy/purple{dir = 8},/turf/simulated/floor/carpet/purple,/area/space)
"XD" = (/obj/effect/floor_decal/asteroid,/turf/unsimulated/floor{icon = 'icons/turf/snow.dmi'; icon_state = "snowwhite"},/area/space)
"XW" = (/obj/structure/flora/tree/dead,/turf/unsimulated/floor{icon_state = "snow"},/area/space)
"Yb" = (/obj/structure/fitness/weightlifter,/turf/simulated/floor/tiled,/area/space)
"Zj" = (/obj/structure/table/gamblingtable,/obj/effect/floor_decal/spline/fancy/wood{dir = 4},/obj/item/storage/pill_bottle/dice_nerd,/turf/simulated/floor/wood/yew,/area/space)
"ZB" = (/obj/item/stool/bar/padded,/obj/effect/floor_decal/spline/fancy/wood{dir = 4},/turf/simulated/floor/wood/yew,/area/space)
"ZD" = (/turf/simulated/floor/carpet/purple,/area/space)
"ZJ" = (/obj/structure/bed/chair/wood{dir = 4},/turf/simulated/floor/wood,/area/space)

(1,1,1) = {"
WUWUWUWUWUWUWUWUWUWUWUWUWUWUWUWUWUWUWUWUWUWUWUWUWUWUWUWUWUWUWUWUWUWUWUWUWUWUWUWUWUWUWUWUWUWUWUWUWUWU
WUWUWUWUWUWUWUWUWUWUWUWUWUWUWUWUWUWUWUWUWUWUWUWUWUWUWUWUWUWUWUWUWUWUWUWUWUWUWUWUWUWUWUWUWUWUWUWUWUWU
WUWUWUWUWUWUWUWUWUWUWUWUWUWUWUWUWUWUWUXDWUWUWUWUWUWUWUWUWUWUWUWUWUWUWUWUWUWUWUWUWUWUWUWUWUWUWUWUWUWU
WUWUWUWUWUWUWUWUWUWUWUWUWUWUWUWUWUWUWUWUWUWUWUWUWUWUWUWUWUWUWUWUWUWUWUWUWUWUWUWUWUWUWUWUWUWUWUWUWUWU
WUWUWUWUWUWUWUWUWUWUWUWUWUWUWUWUWUWUWUWUWUWUWUWUWUWUWUWUWUWUWUWUWUWUWUWUWUWUWUXDWUWUWUWUWUWUWUWUWUWU
WUWUWUWUWUXDWUWUWUWUWUdgWUWUWUWUWUWUWUWUWUWUWUWUWUWUWUWUWUWUWUXDWUWUWUWUWUWUWUWUWUdgWUWUWUWUWUWUWUWU
WUWUWUWUWUWUWUWUWUWUWUWUWUWUWUWUWUWUWUWUzKWUWUWUWUWUWUWUWUWUWUWUWUWUWUWUWUWUWUWUWUWUWUWUWUWUWUWUWUWU
WUWUWUWUWUWUWUWUXDWUWUWUWUWUWUWUXDWUWUWUWUWUWUWUWUWUWUWUWUWUWUWUWUWUWUdgWUWUWUWUWUWUWUWUWUWUWUWUWUWU
WUWUWUWUWUIAWUWUWUWUWUWUWUWUWUWUWUWUWUWUWUWUWUWUdgWUWUWUWUWUWUWUWUWUWUWUWUWUWUWUWUWUWUWUWUWUWUWUWUWU
WUWUWUWUWUdgWUWUGnGnGnGnGnGnGnGnGnGnWUWUWUWUWUWUWUWUWUWUWUWUXDXDWUWUWUWUWUWUWUWUWUWUWUWUWUWUWUWUWUWU
WUWUWUWUXDWUWUWUGnMePOGnMeQdGnMemtGnGnGnGnGnWUWUWUWUWUWUWUWUWUWUWUWUWUWUWUWUWUWUWUWUWUWUWUWUWUWUWUWU
WUWUWUWUWUWUWUWUGnKVKVGnKVKVGnKVKVGnHmtRIsGnWUXDWUWUWUWUWUWUGnGnGnGncycycyGnGnWUWUWUWUWUWUWUWUWUWUWU
WUWUWUWUWUWUWUWUGnLCGnGnLCGnGnLCGnGnVninaZGnWUWUWUWUWUWUWUWUGnMgGgbVIhOvDIOSGnWUWUWUdgWUWUWUWUWUWUWU
WUWUWUWUWUWUzKWUGnMgMgysiCMgMgMgMgGnGnwgGnGncycycycyGnGnGnGnGnSyGgbVPcplplCbcyWUWUWUWUWUWUWUWUWUWUWU
WUWUWUWUWUWUWUWUGnGnGnMgMgMgMgMgMgcyMgFdcLMgMgMgMgMgysiCMgMgpbMgGgbVplxUplOScyWUWUWUWUWUWUWUWUWUWUWU
WUWUWUWUdgWUWUWUGnhxGPiCMgMgMgMgiCnfMgMgMgBjMgMgiCMgMgMgMgMgnfiCMgAyadplplzxcyWUXDWUWUWUWUWUWUWUWUWU
WUWUWUWUWUWUWUWUGnGnGnGnGnGnBBBBGnGnGncycyGnGnnfnfGnGncycyGnGnMgMgGnGnyOGnGnGnWUWUWUWUWUWUWUWUWUWUWU
WUWUWUWUWUWUWUWUWUWUGnMgMgQvFFFFzDGnWUXDWUWUWUCidRaCWUWUWUWUGnINMgGnAbbcbcgNGnWUWUWUWUWUWUXDWUWUWUWU
WUWUWUWUWUWUWUWUXDWUGnSyHEMgFFYbOHGnWUdRCidRCiCiCiCiCidRCiWUGnnfcyGnCkuabcjWGnWUWUWUWUWUWUWUWUWUWUWU
WUWUWUWUWUXDWUWUWUWUGnNzMgPdFFFFzDGnWUCiXWCiWUXDWUWUCiDbCiWUcyMgMgGnGnGnGnGnGnWUWUWUWUdgWUWUWUWUWUWU
WUWUWUWUIAWUWUWUWUWUGnzDzDzDFFFFHkGnWUCiCiCiWUWUWUWUCiCiCiWUcyMgeIGnDBEGlozzGnWUWUWUWUWUWUWUWUWUWUWU
WUWUWUWUXWWUWUWUdgWUGnGnGnGnBBBBGnGnWUCiWUWUUHLKUHLKWUWUdRWUGnMgMgcyhzsosrZBcyWUWUWUWUWUWUWUWUWUWUWU
WUWUWUWUCidRCiCidRCinfMgMgMgMgMgMgnfCiCiWUWULKKgKgLKWUWUdRCinfMgMgnfhzBZswZjcyWUWUWUWUWUWUWUWUWUWUWU
WUWUWUWUdRCiCidRCiCinfZJMwEpMgluMgnfCidRWUWULKKgKgUHWUWUCiCinfMgMgnfBDBZsrZBcyWUWUWUWUWUWUWUWUWUWUWU
WUWUWUWUIAWUWUWUWUWUcyZJsiEpMgkvEpcyWUdRWUWULKUHLKLKWUWUCiWUGnMgMgcynXbysrsgcyWUWUWUWUWUWUWUWUWUWUWU
WUWUWUWUXWWUWUWUdgWUGnBjMgMgMgMgBjGnWUCiCiCiWUWUWUWUCiCiCiWUcyMgeIGnOtaGFIMvGnWUWUWUWUWUWUXDWUWUWUWU
WUXDWUWUWUWUWUXDWUWUGnGncynfnfcyGnGnWUCizKCiWUWUWUWUCidgdRXDcyMgMgGnGnGnGnFiGnGnGnWUWUWUWUWUWUWUWUWU
WUWUWUWUWUWUWUWUWUWUWUWUWUCiCiWUWUWUWUdRCiCiCidRdRCiCiCiCiWUGnMgMgGnMefOGnZDTmZDGnWUWUWUWUWUWUWUWUWU
WUWUWUWUWUWUWUWUWUdRCiCiCiCiCiCiCidRWUWUWUWUWUCiCiWUWUWUWUWUGnINMgLCKVKVGnkyqdXBGnWUWUzKWUWUWUWUWUWU
WUWUWUWUWUWUWUWUWUCiCidRCiCiCiCiCiCiWUWUWUWUWUdRCiWUXDWUWUWUGnMgMgGnMZKVGnRHNQZDGnWUWUWUWUWUWUWUWUWU
WUWUWUWUWUWUWUWUWUCiCiCiCiCiCidRCiCiWUXDWUWUWUCidRWUWUGnGnGnGnnfGnGnGnGnGnGnGnGnGnWUWUWUWUWUWUWUWUWU
WUWUWUWUWUWUWUWUWUdRdRCidRCiCidRCiCiWUWUWUWUWUCiCiWUUgGnlODLGnaNWqWqCzWqweGnWUWUWUWUWUWUWUWUWUWUWUWU
WUWUWUWUWUWUWUWUWUCidRCiCiCiCiCiCidRCidRCiCiCiCidRCiCicbZDZDxNaNWqlTNdikWqGnWUWUXDWUWUWUWUWUWUWUWUWU
WUWUWUzKWUWUWUWUWUCiCiCiCidRCiCiCiCiCiCiCidRCiCiCiCiCicbZDZDxNaNWqikixikWqGnWUWUWUWUWUWUWUWUWUWUWUWU
WUWUWUWUWUWUWUWUWUdRCiCiCiCiCiCiCiCiWUWUWUWUWUWUWUWUWUGnxMaxGnaNWqWqwrWqWqGnWUWUWUWUWUWUWUWUWUWUWUWU
WUWUWUWUWUWUWUWUWUCiCidRCiCidRCiCiCiWUWUWUXDWUWUWUWUWUGnGnGnGnGnGnGnGnGnGnGnWUWUWUWUWUWUWUWUWUWUWUWU
WUWUWUWUWUWUWUWUWUCiCiCiCiCiCiCiCiCiWUWUWUWUWUWUWUWUWUWUWUWUWUWUWUWUWUWUWUWUWUWUWUWUWUWUWUWUWUWUWUWU
WUWUWUWUWUWUWUWUWUWUWUWUWUWUWUWUWUWUWUWUWUWUWUWUWUWUWUWUWUWUWUWUWUWUWUWUWUWUWUWUWUWUWUWUWUWUWUWUWUWU
WUWUWUWUWUdgWUWUWUWUWUWUWUWUWUWUWUWUWUWUdgWUWUWUWUWUWUXDWUWUWUWUWUWUWUWUWUWUWUWUWUWUWUWUWUWUWUWUWUWU
WUWUWUWUWUWUWUWUWUWUWUWUWUWUWUWUWUWUWUWUWUWUWUWUWUWUWUWUWUWUWUWUWUWUWUWUWUWUWUWUWUWUWUWUWUWUWUWUWUWU
WUWUWUWUWUWUWUWUWUWUWUWUWUXDWUWUWUWUWUWUWUWUWUWUWUWUWUWUWUWUWUWUWUWUzKWUWUWUWUWUWUWUWUdgWUWUWUWUWUWU
WUWUWUXDWUWUWUWUWUWUWUWUWUWUWUWUWUWUWUWUWUWUWUWUWUdgWUWUWUWUWUXDWUWUWUWUWUWUWUWUWUWUWUWUWUWUWUWUWUWU
WUWUWUWUWUWUWUWUWUWUWUWUWUWUWUWUWUWUWUzKWUXDWUWUWUWUWUWUWUWUWUWUWUWUWUWUWUWUWUWUWUWUWUWUWUWUWUWUWUWU
WUWUWUWUWUWUWUWUWUzKWUWUWUWUWUWUWUWUWUWUWUWUWUWUWUWUWUWUWUWUWUWUWUWUWUWUWUWUWUWUWUWUWUWUWUWUWUWUWUWU
WUWUWUWUXDWUWUWUWUWUWUWUWUWUWUWUWUWUWUWUWUWUWUWUWUWUWUWUWUWUWUWUWUWUWUWUWUWUWUWUWUWUWUWUWUWUWUWUWUWU
WUWUWUWUWUWUWUWUWUWUWUWUWUWUdgWUWUWUWUWUWUWUWUWUWUWUWUWUWUWUWUXDWUWUWUWUWUWUWUWUWUWUWUXDWUWUWUWUWUWU
WUWUWUWUWUWUWUWUWUWUWUWUWUWUWUWUWUWUWUWUWUWUWUWUWUWUWUWUWUWUWUWUWUWUWUWUWUWUWUWUWUWUWUWUWUWUWUWUWUWU
WUWUWUWUWUWUWUWUWUWUWUWUWUWUWUWUWUWUWUWUWUWUWUWUWUWUWUWUWUWUWUWUWUWUWUWUWUWUWUWUWUWUWUWUWUWUWUWUWUWU
WUWUWUWUWUWUWUWUWUWUWUWUWUWUWUWUWUWUWUWUWUWUWUWUWUWUWUWUWUWUWUWUWUWUWUWUWUWUWUWUWUWUWUWUWUWUWUWUWUWU
WUWUWUWUWUWUWUWUWUWUWUWUWUWUWUWUWUWUWUWUWUWUWUWUWUWUWUWUWUWUWUWUWUWUWUWUWUWUWUWUWUWUWUWUWUWUWUWUWUWU
"}
