"au" = (/obj/structure/table/rack,/obj/item/gun/launcher/crossbow,/obj/item/stack/material/rods{amount = 10},/obj/item/stack/material/rods{amount = 10},/obj/item/stack/material/rods{amount = 10},/obj/item/stack/material/rods{amount = 10},/turf/simulated/floor/plating,/area/map_template/skipjack_station/start)
"be" = (/obj/effect/decal/cleanable/dirt,/obj/machinery/space_heater,/obj/structure/cable{d1 = 1; d2 = 2; icon_state = "1-2"},/turf/simulated/floor/shuttle/red,/area/map_template/skipjack_station/start)
"bU" = (/obj/structure/cable{d1 = 1; d2 = 2; icon_state = "1-2"},/turf/simulated/floor/plating,/area/map_template/skipjack_station/start)
"bV" = (/obj/structure/cable{d1 = 1; d2 = 4; icon_state = "1-4"},/obj/structure/cable{d1 = 1; d2 = 8; icon_state = "1-8"},/turf/simulated/floor/plating,/area/map_template/skipjack_station/start)
"cz" = (/obj/machinery/door/airlock/hatch,/obj/structure/cable{d1 = 1; d2 = 2; icon_state = "1-2"},/turf/simulated/floor/plating,/area/map_template/skipjack_station/start)
"cN" = (/obj/machinery/light/small{dir = 4; pixel_y = 0},/obj/effect/decal/cleanable/dirt,/obj/machinery/power/apc{dir = 4; name = "east bump"; pixel_x = 24},/obj/structure/cable{d2 = 2; icon_state = "0-2"},/turf/simulated/floor/carpet/blue2,/area/map_template/skipjack_station/start)
"dh" = (/obj/machinery/door/airlock/hatch,/obj/structure/cable{d1 = 4; d2 = 8; icon_state = "4-8"},/turf/simulated/floor/carpet/blue2,/area/map_template/skipjack_station/start)
"dS" = (/obj/machinery/light/small,/obj/structure/window/reinforced{dir = 8},/obj/effect/decal/cleanable/dirt,/turf/simulated/floor/plating,/area/map_template/skipjack_station/start)
"eg" = (/obj/structure/closet/crate/trashcart,/obj/item/contraband/poster,/obj/item/contraband/poster,/obj/item/contraband/poster,/obj/item/contraband/poster,/obj/item/tank/hydrogen,/turf/simulated/floor/plating,/area/map_template/skipjack_station/start)
"eO" = (/obj/structure/flora/pottedplant{desc = "Used to bring the room together...before the accident."; icon_state = "plant-25"; name = "Jamie"},/obj/machinery/power/apc{dir = 8; locked = 0; name = "west bump"; pixel_x = -24; req_access = list()},/obj/structure/cable{d2 = 2; icon_state = "0-2"},/turf/simulated/floor/shuttle/red,/area/map_template/skipjack_station/start)
"eQ" = (/obj/structure/table/standard,/obj/item/reagent_containers/syringe/antiviral,/obj/item/reagent_containers/syringe/antiviral,/turf/simulated/floor/shuttle/white,/area/map_template/skipjack_station/start)
"ff" = (/turf/simulated/wall/voxshuttle,/area/map_template/skipjack_station/start)
"gA" = (/obj/random/junk,/turf/simulated/floor/carpet/blue2,/area/map_template/skipjack_station/start)
"gC" = (/turf/simulated/floor/tiled/techfloor/grid,/area/space)
"gP" = (/obj/structure/cable{d1 = 4; d2 = 8; icon_state = "4-8"},/turf/simulated/floor/plating,/area/map_template/skipjack_station/start)
"hE" = (/obj/machinery/optable,/obj/item/clothing/mask/gas,/turf/simulated/floor/shuttle/white,/area/map_template/skipjack_station/start)
"hZ" = (/obj/item/stool/padded,/obj/effect/decal/cleanable/dirt,/turf/simulated/floor/shuttle/red,/area/map_template/skipjack_station/start)
"iq" = (/obj/item/robot_parts/robot_suit,/obj/structure/cable{d1 = 1; d2 = 4; icon_state = "1-4"},/turf/simulated/floor/plating,/area/map_template/skipjack_station/start)
"iu" = (/obj/item/storage/firstaid/surgery,/obj/item/storage/box/syringegun,/obj/structure/table/rack,/obj/item/gun/launcher/syringe/rapid,/turf/simulated/floor/shuttle/white,/area/map_template/skipjack_station/start)
"iI" = (/obj/structure/table/steel,/obj/item/pizzabox/meat,/turf/simulated/floor/shuttle/red,/area/map_template/skipjack_station/start)
"iS" = (/obj/structure/cable{d1 = 4; d2 = 8; icon_state = "4-8"},/obj/structure/cable{d1 = 1; d2 = 8; icon_state = "1-8"},/turf/simulated/floor/shuttle/red,/area/map_template/skipjack_station/start)
"jf" = (/obj/structure/bed,/obj/structure/curtain/open/bed,/obj/item/bedsheet/rd,/turf/simulated/floor/carpet/blue2,/area/map_template/skipjack_station/start)
"jG" = (/obj/structure/bed,/obj/structure/curtain/open/bed,/obj/item/bedsheet/green,/turf/simulated/floor/carpet/blue2,/area/map_template/skipjack_station/start)
"jM" = (/obj/machinery/door/window/southleft{dir = 1; name = "Containment Pen"},/turf/unsimulated/floor{icon_state = "snow"},/area/map_template/skipjack_station/start)
"jS" = (/obj/item/stool/padded,/turf/simulated/floor/plating,/area/map_template/skipjack_station/start)
"ky" = (/obj/machinery/door/airlock/hatch,/turf/simulated/floor/shuttle/red,/area/map_template/skipjack_station/start)
"kD" = (/obj/structure/reagent_dispensers/beerkeg,/turf/simulated/floor/shuttle/red,/area/map_template/skipjack_station/start)
"mb" = (/obj/structure/table/rack,/obj/item/card/emag,/obj/item/clothing/accessory/armor_plate/sneaky,/obj/item/clothing/accessory/armor_plate/sneaky,/obj/item/clothing/mask/gas/syndicate,/obj/item/clothing/mask/gas/swat,/obj/item/clothing/head/cowboy_hat,/turf/simulated/floor/plating,/area/map_template/skipjack_station/start)
"mc" = (/obj/structure/cable{d1 = 1; d2 = 2; icon_state = "1-2"},/turf/unsimulated/floor{icon_state = "snow"},/area/map_template/skipjack_station/start)
"mo" = (/obj/structure/bed,/obj/machinery/light/small{dir = 4; pixel_y = 0},/turf/simulated/floor/plating,/area/map_template/skipjack_station/start)
"mw" = (/obj/structure/shuttle/engine/heater,/obj/structure/window/reinforced/crescent{dir = 1},/turf/simulated/floor/plating,/area/map_template/skipjack_station/start)
"mK" = (/obj/structure/cable{d1 = 4; d2 = 8; icon_state = "4-8"},/obj/machinery/power/apc{name = "south bump"; pixel_y = -24},/obj/structure/cable{d2 = 4; icon_state = "0-4"},/obj/structure/cable{d1 = 1; d2 = 8; icon_state = "1-8"},/turf/simulated/floor/plating,/area/map_template/skipjack_station/start)
"mQ" = (/obj/structure/cable{d1 = 4; d2 = 8; icon_state = "4-8"},/turf/unsimulated/floor{icon_state = "snow"},/area/map_template/skipjack_station/start)
"mU" = (/obj/structure/table/rack,/obj/random/ammo,/obj/random/ammo,/turf/simulated/floor/plating,/area/map_template/skipjack_station/start)
"nD" = (/obj/structure/table/steel,/obj/machinery/recharger,/turf/simulated/floor/shuttle/red,/area/map_template/skipjack_station/start)
"nI" = (/obj/structure/table/rack,/obj/item/gun/projectile/pirate,/obj/item/gun/projectile/pirate,/obj/item/gun/projectile/sniper/semistrip,/turf/simulated/floor/plating,/area/map_template/skipjack_station/start)
"nL" = (/obj/machinery/light/small{dir = 8},/turf/simulated/floor/plating,/area/map_template/skipjack_station/start)
"nQ" = (/obj/machinery/light/small,/turf/simulated/floor/shuttle/red,/area/map_template/skipjack_station/start)
"nX" = (/obj/structure/cable{d1 = 1; d2 = 4; icon_state = "1-4"},/turf/simulated/floor/plating,/area/map_template/skipjack_station/start)
"od" = (/turf/simulated/floor/plating,/area/space)
"ov" = (/obj/structure/table/standard,/obj/item/wrench,/obj/item/robot_parts/l_leg,/obj/item/robot_parts/r_arm,/obj/item/robot_parts/r_leg,/turf/simulated/floor/plating,/area/map_template/skipjack_station/start)
"oy" = (/obj/effect/decal/cleanable/dirt,/obj/structure/cable{d1 = 1; d2 = 2; icon_state = "1-2"},/turf/simulated/floor/shuttle/red,/area/map_template/skipjack_station/start)
"oO" = (/obj/structure/table/rack,/obj/item/gun/projectile/pistol/holdout,/obj/item/gun/projectile/revolver/holdout,/obj/item/gun/projectile/pistol/broomstick,/obj/machinery/light/small{dir = 1},/obj/random/lilgun,/turf/simulated/floor/plating,/area/map_template/skipjack_station/start)
"oS" = (/obj/structure/table/rack,/obj/item/storage/box/canned/beans,/obj/item/storage/box/canned/beef,/obj/item/storage/box/canned/tomato,/obj/item/reagent_containers/food/snacks/canned/tomato,/obj/item/reagent_containers/food/snacks/canned/spinach,/obj/item/reagent_containers/food/snacks/canned/caviar/true,/obj/item/reagent_containers/food/snacks/canned/caviar,/turf/simulated/floor/shuttle/red,/area/map_template/skipjack_station/start)
"pW" = (/obj/structure/table/steel,/obj/item/music_player/boombox/custom_tape,/turf/simulated/floor/shuttle/red,/area/map_template/skipjack_station/start)
"pX" = (/obj/structure/table/standard,/obj/item/handcuffs/cable,/obj/item/handcuffs/cable{pixel_y = 10},/turf/simulated/floor/plating,/area/map_template/skipjack_station/start)
"qy" = (/obj/effect/paint/brown,/turf/simulated/wall/voxshuttle,/area/map_template/skipjack_station/start)
"qC" = (/obj/item/frame/apc,/turf/simulated/floor/shuttle/red,/area/map_template/skipjack_station/start)
"qE" = (/obj/structure/cable{d1 = 1; d2 = 8; icon_state = "1-8"},/turf/simulated/floor/plating,/area/map_template/skipjack_station/start)
"qR" = (/obj/machinery/floodlight,/turf/simulated/floor/tiled/techfloor/grid,/area/map_template/skipjack_station/start)
"rt" = (/obj/structure/table/steel,/obj/random/contraband,/turf/simulated/floor/shuttle/red,/area/map_template/skipjack_station/start)
"rG" = (/obj/structure/closet/crate/plastic,/obj/item/storage/backpack/dufflebag/syndie,/obj/item/storage/backpack/dufflebag,/obj/item/clothing/accessory/medal/gold,/obj/item/clothing/glasses/aviators_gold,/obj/item/stack/material/gold,/obj/item/ore/gold,/obj/item/ore/gold,/obj/item/ore/gold,/obj/item/ore/gold,/obj/item/ore/gold,/obj/item/ore/gold,/obj/item/ore/gold,/obj/item/material/coin/gold,/obj/item/clothing/ring/material/gold,/obj/item/clothing/ears/earring/dangle/gold,/obj/item/clothing/ears/earring/stud/gold,/turf/simulated/floor/plating,/area/map_template/skipjack_station/start)
"rU" = (/obj/structure/closet/firecloset,/turf/simulated/floor/plating,/area/map_template/skipjack_station/start)
"sk" = (/obj/machinery/door/airlock/hatch,/turf/simulated/floor/plating,/area/map_template/skipjack_station/start)
"sm" = (/obj/structure/table/rack,/turf/simulated/floor/shuttle/red,/area/map_template/skipjack_station/start)
"tb" = (/obj/machinery/power/apc{dir = 1; name = "north bump"; pixel_y = 24},/obj/structure/cable{d2 = 2; icon_state = "0-2"},/turf/simulated/floor/plating,/area/map_template/skipjack_station/start)
"th" = (/obj/machinery/door/airlock/hatch,/obj/structure/cable{d1 = 4; d2 = 8; icon_state = "4-8"},/turf/simulated/floor/shuttle/white,/area/map_template/skipjack_station/start)
"tJ" = (/obj/structure/table/standard,/obj/item/clothing/mask/muzzle,/obj/item/clothing/glasses/blindfold{pixel_y = 3},/turf/simulated/floor/plating,/area/map_template/skipjack_station/start)
"tK" = (/obj/structure/plushie/drone,/turf/simulated/floor/tiled/techfloor/grid,/area/map_template/skipjack_station/start)
"ud" = (/obj/random/trash,/obj/effect/decal/cleanable/dirt,/turf/simulated/floor/shuttle/white,/area/map_template/skipjack_station/start)
"uz" = (/obj/machinery/light/small{dir = 4; pixel_y = 0},/obj/effect/decal/cleanable/dirt,/turf/simulated/floor/plating,/area/map_template/skipjack_station/start)
"va" = (/obj/machinery/constructable_frame/computerframe,/turf/simulated/floor/shuttle/red,/area/map_template/skipjack_station/start)
"vF" = (/obj/structure/cable{d1 = 4; d2 = 8; icon_state = "4-8"},/turf/simulated/floor/tiled/techfloor/grid,/area/map_template/skipjack_station/start)
"wd" = (/obj/machinery/power/smes/buildable/preset/torch/substation{RCon_tag = "Substation - First Deck"},/turf/simulated/floor/plating,/area/map_template/skipjack_station/start)
"wg" = (/obj/effect/decal/cleanable/dirt,/turf/simulated/floor/shuttle/red,/area/map_template/skipjack_station/start)
"wt" = (/obj/structure/reagent_dispensers/fueltank,/turf/simulated/floor/plating,/area/map_template/skipjack_station/start)
"wD" = (/obj/effect/decal/cleanable/blood,/turf/simulated/floor/plating,/area/map_template/skipjack_station/start)
"wI" = (/obj/structure/window/reinforced{dir = 8},/obj/structure/window/reinforced{dir = 1},/turf/simulated/floor/plating,/area/map_template/skipjack_station/start)
"wK" = (/obj/machinery/door/airlock/hatch,/obj/structure/cable{d1 = 1; d2 = 2; icon_state = "1-2"},/turf/simulated/floor/shuttle/red,/area/map_template/skipjack_station/start)
"xo" = (/obj/structure/table/steel,/turf/simulated/floor/shuttle/red,/area/map_template/skipjack_station/start)
"ym" = (/obj/item/stool/padded,/obj/structure/cable{d1 = 4; d2 = 8; icon_state = "4-8"},/turf/simulated/floor/shuttle/red,/area/map_template/skipjack_station/start)
"yx" = (/obj/effect/decal/cleanable/dirt,/obj/structure/cable{d1 = 4; d2 = 8; icon_state = "4-8"},/turf/simulated/floor/shuttle/red,/area/map_template/skipjack_station/start)
"yG" = (/obj/item/clothing/suit/storage/toggle/bomber,/obj/effect/decal/cleanable/dirt,/turf/simulated/floor/carpet/blue2,/area/map_template/skipjack_station/start)
"yH" = (/obj/item/stack/material/rods{amount = 10},/turf/unsimulated/floor{icon_state = "snow"},/area/space)
"yP" = (/obj/random/maintenance,/turf/simulated/floor/shuttle/white,/area/map_template/skipjack_station/start)
"zM" = (/obj/structure/bed/chair/office/light{dir = 4},/turf/simulated/floor/shuttle/red,/area/map_template/skipjack_station/start)
"Ai" = (/obj/structure/cable{d1 = 2; d2 = 4; icon_state = "2-4"},/turf/simulated/floor/tiled/techfloor/grid,/area/map_template/skipjack_station/start)
"Ap" = (/obj/structure/window/reinforced{dir = 8},/obj/structure/window/reinforced{dir = 1},/turf/unsimulated/floor{icon_state = "snow"},/area/map_template/skipjack_station/start)
"Au" = (/obj/structure/bed,/obj/structure/curtain/open/bed,/obj/item/bedsheet/rainbow,/turf/simulated/floor/carpet/blue2,/area/map_template/skipjack_station/start)
"Aw" = (/obj/random/junk,/turf/simulated/floor/plating,/area/map_template/skipjack_station/start)
"AU" = (/obj/structure/bed,/obj/structure/curtain/open/bed,/obj/item/bedsheet/hos,/obj/random/plushie,/turf/simulated/floor/carpet/blue2,/area/map_template/skipjack_station/start)
"Bj" = (/obj/random/obstruction,/turf/simulated/floor/plating,/area/map_template/skipjack_station/start)
"BB" = (/obj/machinery/bodyscanner{dir = 8},/turf/simulated/floor/shuttle/white,/area/map_template/skipjack_station/start)
"BN" = (/obj/structure/table/steel,/obj/random/smokes{pixel_y = 7; pixel_x = 7},/obj/random/smokes,/turf/simulated/floor/shuttle/red,/area/map_template/skipjack_station/start)
"Cl" = (/obj/random/obstruction,/turf/unsimulated/floor{icon_state = "snow"},/area/space)
"Cu" = (/obj/machinery/power/terminal{dir = 1},/obj/structure/cable{d2 = 8; icon_state = "0-8"},/obj/effect/decal/cleanable/dirt,/turf/simulated/floor/plating,/area/map_template/skipjack_station/start)
"CL" = (/obj/effect/wallframe_spawn/reinforced/titanium,/turf/simulated/floor/plating,/area/map_template/skipjack_station/start)
"CR" = (/obj/structure/table/steel,/obj/item/storage/box/glasses/rocks,/turf/simulated/floor/plating,/area/map_template/skipjack_station/start)
"Ek" = (/obj/structure/undies_wardrobe,/turf/simulated/floor/carpet/blue2,/area/map_template/skipjack_station/start)
"Ev" = (/obj/machinery/body_scanconsole{dir = 8},/obj/machinery/light/small{dir = 1},/turf/simulated/floor/shuttle/white,/area/map_template/skipjack_station/start)
"EA" = (/obj/machinery/light/small{dir = 1},/turf/simulated/floor/plating,/area/map_template/skipjack_station/start)
"EV" = (/obj/machinery/light/small{dir = 1},/obj/machinery/power/apc{dir = 1; name = "north bump"; pixel_y = 24; req_access = list("ACCESS_MERCHANT")},/obj/structure/cable{d2 = 2; icon_state = "0-2"},/turf/simulated/floor/plating,/area/map_template/skipjack_station/start)
"Fd" = (/obj/machinery/light/small{dir = 4; pixel_y = 0},/obj/random/trash,/obj/item/clothing/head/helmet/merc,/obj/structure/cable{d1 = 1; d2 = 2; icon_state = "1-2"},/turf/simulated/floor/plating,/area/map_template/skipjack_station/start)
"FR" = (/turf/simulated/floor/tiled/techfloor/grid,/area/map_template/skipjack_station/start)
"FZ" = (/obj/structure/bed,/obj/effect/decal/cleanable/blood,/turf/simulated/floor/plating,/area/map_template/skipjack_station/start)
"Ga" = (/obj/structure/table/rack,/obj/item/beartrap,/obj/item/grenade/spawnergrenade/viscerator,/obj/item/grenade/spawnergrenade/viscerator,/obj/item/grenade/flashbang,/obj/item/grenade/flashbang,/obj/item/grenade/empgrenade,/obj/item/plastique,/obj/item/grenade/smokebomb,/turf/simulated/floor/plating,/area/map_template/skipjack_station/start)
"Ge" = (/obj/item/stack/material/steel{amount = 50},/turf/unsimulated/floor{icon_state = "snow"},/area/space)
"Go" = (/obj/effect/decal/cleanable/dirt,/obj/structure/cable{d1 = 1; d2 = 2; icon_state = "1-2"},/turf/simulated/floor/shuttle/white,/area/map_template/skipjack_station/start)
"GJ" = (/obj/machinery/floodlight,/turf/simulated/floor/plating,/area/map_template/skipjack_station/start)
"Hd" = (/obj/machinery/light/small{dir = 1},/obj/machinery/power/port_gen/pacman{anchored = 1; sheets = 25},/obj/item/stack/material/phoron/ten,/obj/structure/cable{d2 = 2; icon_state = "0-2"},/turf/simulated/floor/plating,/area/map_template/skipjack_station/start)
"Hn" = (/obj/structure/cable{d1 = 1; d2 = 4; icon_state = "1-4"},/obj/structure/cable{d1 = 2; d2 = 4; icon_state = "2-4"},/turf/simulated/floor/plating,/area/map_template/skipjack_station/start)
"IQ" = (/obj/effect/paint/black,/turf/simulated/wall/voxshuttle,/area/map_template/skipjack_station/start)
"KZ" = (/obj/effect/decal/cleanable/dirt,/obj/structure/cable{d1 = 1; d2 = 2; icon_state = "1-2"},/obj/structure/cable{d1 = 2; d2 = 8; icon_state = "2-8"},/turf/simulated/floor/plating,/area/map_template/skipjack_station/start)
"Ly" = (/obj/structure/table/steel,/obj/item/clothing/glasses/threedglasses,/obj/item/clothing/mask/smokable/cigarette/cigar/havana,/turf/simulated/floor/plating,/area/map_template/skipjack_station/start)
"Ne" = (/obj/structure/cable{d1 = 2; d2 = 8; icon_state = "2-8"},/turf/simulated/floor/plating,/area/map_template/skipjack_station/start)
"Ng" = (/obj/item/clothing/glasses/eyepatch,/turf/simulated/floor/shuttle/red,/area/map_template/skipjack_station/start)
"NT" = (/obj/structure/table/standard,/obj/item/material/knife/combat,/turf/simulated/floor/plating,/area/map_template/skipjack_station/start)
"On" = (/obj/random/trash,/obj/machinery/power/apc{dir = 4; name = "east bump"; pixel_x = 24},/obj/structure/cable{d2 = 2; icon_state = "0-2"},/turf/simulated/floor/shuttle/white,/area/map_template/skipjack_station/start)
"Ot" = (/obj/structure/table/rack,/obj/item/clothing/accessory/storage/webbing,/obj/item/clothing/accessory/storage/webbing_large,/obj/item/storage/belt/holster/security/tactical,/obj/item/storage/belt/holster/security,/obj/item/clothing/accessory/storage/black_vest,/obj/effect/decal/cleanable/dirt,/turf/simulated/floor/plating,/area/map_template/skipjack_station/start)
"Ow" = (/turf/unsimulated/floor{icon_state = "snow"},/area/space)
"OR" = (/obj/structure/cable{d1 = 4; d2 = 8; icon_state = "4-8"},/obj/structure/cable{d1 = 1; d2 = 8; icon_state = "1-8"},/turf/unsimulated/floor{icon_state = "snow"},/area/map_template/skipjack_station/start)
"OV" = (/obj/effect/decal/cleanable/dirt,/obj/structure/cable{d1 = 1; d2 = 4; icon_state = "1-4"},/turf/simulated/floor/plating,/area/map_template/skipjack_station/start)
"Pc" = (/obj/structure/table/steel,/obj/machinery/chemical_dispenser/bar_soft/full,/turf/simulated/floor/plating,/area/map_template/skipjack_station/start)
"PL" = (/obj/effect/decal/cleanable/dirt,/turf/simulated/floor/tiled/techfloor/grid,/area/map_template/skipjack_station/start)
"Ql" = (/obj/structure/table/steel,/obj/item/material/ashtray/bronze,/obj/item/trash/cigbutt/cigarbutt,/turf/simulated/floor/plating,/area/map_template/skipjack_station/start)
"Qm" = (/obj/effect/decal/cleanable/dirt,/turf/simulated/floor/plating,/area/map_template/skipjack_station/start)
"Qu" = (/obj/random/trash,/obj/structure/cable{d1 = 4; d2 = 8; icon_state = "4-8"},/turf/simulated/floor/shuttle/red,/area/map_template/skipjack_station/start)
"Qx" = (/obj/machinery/light/small,/turf/simulated/floor/shuttle/white,/area/map_template/skipjack_station/start)
"QD" = (/obj/machinery/door/airlock/hatch,/obj/structure/cable{d1 = 4; d2 = 8; icon_state = "4-8"},/turf/simulated/floor/shuttle/red,/area/map_template/skipjack_station/start)
"QP" = (/obj/effect/decal/cleanable/dirt,/obj/structure/cable{d1 = 1; d2 = 2; icon_state = "1-2"},/turf/simulated/floor/plating,/area/map_template/skipjack_station/start)
"Rg" = (/obj/structure/table/standard,/obj/item/storage/toolbox/syndicate,/turf/simulated/floor/tiled/techfloor/grid,/area/map_template/skipjack_station/start)
"RM" = (/obj/machinery/light/small{dir = 8},/obj/structure/cable{d1 = 1; d2 = 2; icon_state = "1-2"},/turf/simulated/floor/plating,/area/map_template/skipjack_station/start)
"Sl" = (/obj/structure/fireaxecabinet{pixel_y = 31},/turf/simulated/floor/shuttle/red,/area/map_template/skipjack_station/start)
"Sq" = (/obj/structure/window/reinforced{dir = 8},/turf/simulated/floor/plating,/area/map_template/skipjack_station/start)
"SE" = (/obj/effect/decal/cleanable/dirt,/obj/machinery/power/apc{dir = 4; name = "west bump"; pixel_x = 24},/obj/structure/cable{d2 = 2; icon_state = "0-2"},/turf/simulated/floor/plating,/area/map_template/skipjack_station/start)
"SG" = (/obj/structure/table/rack,/obj/item/beartrap,/obj/item/beartrap,/obj/item/beartrap,/obj/item/beartrap,/obj/item/beartrap,/obj/item/beartrap,/obj/item/beartrap,/turf/simulated/floor/plating,/area/map_template/skipjack_station/start)
"SU" = (/obj/item/robot_parts/head,/obj/structure/cable{d1 = 1; d2 = 2; icon_state = "1-2"},/turf/simulated/floor/plating,/area/map_template/skipjack_station/start)
"Tm" = (/obj/structure/table/rack,/obj/item/material/sword/katana,/obj/machinery/light/small,/obj/effect/decal/cleanable/dirt,/turf/simulated/floor/plating,/area/map_template/skipjack_station/start)
"Ui" = (/obj/structure/closet{name = "Clothing Storage"},/obj/random/contraband,/obj/item/clothing/under/lawyer/black,/obj/item/clothing/under/rank/dispatch,/obj/item/clothing/suit/pirate,/obj/item/clothing/suit/pirate,/obj/item/clothing/suit/pirate,/obj/item/clothing/suit/storage/toggle/bomber,/obj/item/clothing/suit/storage/hooded/wintercoat,/obj/item/clothing/suit/storage/hooded/wintercoat/solgov/army,/obj/item/clothing/suit/storage/toggle/labcoat/coat,/obj/item/clothing/under/lawyer/infil,/turf/simulated/floor/carpet/blue2,/area/map_template/skipjack_station/start)
"UH" = (/obj/structure/table/rack,/obj/item/storage/firstaid/o2{pixel_x = 3; pixel_y = 3},/obj/item/storage/firstaid/fire{pixel_x = 1},/obj/item/storage/firstaid/toxin{pixel_x = 3; pixel_y = 3},/obj/item/storage/firstaid/adv{pixel_x = 1},/obj/item/melee/baton/cattleprod,/obj/structure/cable{d1 = 1; d2 = 2; icon_state = "1-2"},/turf/simulated/floor/shuttle/white,/area/map_template/skipjack_station/start)
"UY" = (/obj/machinery/space_heater,/turf/simulated/floor/plating,/area/map_template/skipjack_station/start)
"Va" = (/obj/machinery/fabricator/hacked,/obj/item/stack/material/steel{amount = 50},/obj/item/stack/material/glass{amount = 50},/turf/simulated/floor/plating,/area/map_template/skipjack_station/start)
"Vo" = (/obj/machinery/power/apc{dir = 1; name = "north bump"; pixel_y = 24; req_access = list("ACCESS_MERCHANT")},/obj/structure/cable{d2 = 8; icon_state = "0-8"},/turf/simulated/floor/tiled/techfloor/grid,/area/map_template/skipjack_station/start)
"Vp" = (/turf/unsimulated/floor{icon_state = "snow"},/area/map_template/skipjack_station/start)
"Vr" = (/turf/template_noop,/area/space)
"VZ" = (/turf/simulated/floor/shuttle/red,/area/map_template/skipjack_station/start)
"Wn" = (/obj/structure/table/woodentable,/obj/random/contraband,/turf/simulated/floor/carpet/blue2,/area/map_template/skipjack_station/start)
"WA" = (/turf/simulated/floor/plating,/area/map_template/skipjack_station/start)
"WL" = (/obj/machinery/door/window/southleft{dir = 1; name = "Containment Pen"},/obj/effect/decal/cleanable/dirt,/turf/simulated/floor/plating,/area/map_template/skipjack_station/start)
"XE" = (/obj/effect/decal/cleanable/dirt,/obj/structure/cable{d1 = 4; d2 = 8; icon_state = "4-8"},/turf/simulated/floor/plating,/area/map_template/skipjack_station/start)
"XP" = (/turf/simulated/floor/carpet/blue2,/area/map_template/skipjack_station/start)
"Yw" = (/obj/structure/shuttle/engine/propulsion,/obj/effect/paint/black,/turf/simulated/wall/voxshuttle,/area/map_template/skipjack_station/start)
"YI" = (/obj/structure/cable{d1 = 1; d2 = 2; icon_state = "1-2"},/obj/structure/cable{d1 = 2; d2 = 8; icon_state = "2-8"},/turf/simulated/floor/plating,/area/map_template/skipjack_station/start)
"YY" = (/obj/machinery/door/airlock/hatch,/obj/structure/cable{d1 = 4; d2 = 8; icon_state = "4-8"},/turf/simulated/floor/plating,/area/map_template/skipjack_station/start)

(1,1,1) = {"
VrVrVrVrVrVrVrVrVrVrVrVrVrVrVrVrVrVrVrVrVrVrVrVrVrVrVrVrVrVrVrVrVrVrVr
VrOwOwOwOwOwOwOwOwOwOwOwOwOwOwOwOwOwOwOwOwOwOwOwOwOwOwOwOwOwOwOwOwOwVr
VrOwOwOwOwOwOwOwOwOwOwOwOwOwOwOwOwOwOwOwOwOwOwOwOwOwOwOwOwOwOwOwOwOwVr
VrOwOwOwOwOwOwOwOwOwOwOwOwOwIQCLCLCLIQOwOwOwOwOwOwOwOwOwOwOwOwOwOwOwVr
VrOwOwOwOwOwOwOwOwOwOwOwVpBjffvavaWAffIQOwOwOwOwOwOwOwOwOwOwOwOwOwOwVr
VrOwOwOwOwOwOwOwOwOwOwOwIQIQVZWAzMvaVZIQClOwOwOwOwOwOwOwOwOwOwOwOwOwVr
VrOwOwOwOwOwOwOwOwOwOwOwffIQsmWAVZqCVZBjOwOwOwOwOwOwOwOwOwOwOwOwOwOwVr
VrOwOwOwOwOwOwOwOwOwOwOwIQIQmUnQVZnQrUffIQOwOwOwOwOwOwOwOwOwOwOwOwOwVr
VrOwOwOwOwOwOwOwOwOwOwOwqyqyqyqykyqyBjqyqyOwOwOwOwOwOwOwOwOwOwOwOwOwVr
VrOwOwOwOwOwOwOwOwOwOwqyqyxoPcWAwgSlQmkDqyqyOwOwOwOwOwOwOwOwOwOwOwOwVr
VrOwOwOwOwOwOwOwOwOwffmbqyCRVZhZhZjSVZnDqyWAqyOwOwOwOwOwOwOwOwOwOwOwVr
VrOwOwOwOwOwOwOwOwqyoOSEqyeOVZiIBNpWVZSGqyOwOwOwOwOwOwOwOwOwOwOwOwOwVr
VrOwOwOwOwOwOwOwOwCLOtFdqybeWALyQlrtwgoSBjWAOwOwOwOwOwOwOwOwOwOwOwOwVr
VrOwOwOwOwOwOwOwOwCLnIOVQDiSQuymymymyxNekyWAOwOwOwOwOwOwOwOwOwOwOwOwVr
VrOwOwOwOwOwOwOwOwCLauWAkyVZwgNgVZWAVZoykyVpWAOwyHOwOwOwOwOwOwOwOwOwVr
VrOwOwOwOwOwOwOwOwCLGauzqyskqyffqyqyqywKqyQmyHOwOwGeOwOwodOwOwOwOwOwVr
VrOwOwOwOwOwOwOwOwqyTmWAqygAUYUiEkWnqyRMBjWAOwOwodOwOwOwOwOwOwGeOwOwVr
VrOwOwOwOwOwOwOwOwOwqyVaqynLyGXPAwcNqymcBjOwOwOwOwOwOwodOwyHOwOwOwOwVr
VrOwOwOwOwOwOwOwOwOwOwqyqyjfAuAUjGnXdhYIqyffOwGeOwOwyHOwOwOwOwGeOwOwVr
VrOwOwOwOwOwOwOwOwOwOwOwqyqyqyqyqyqyqyczqyOwOwOwOwOwOwodOwGeOwOwOwOwVr
VrOwOwOwOwOwOwOwOwOwOwqyBBEvqypXtJtbEAQPWAqyffqyffqyOwOwOwOwOwOwOwOwVr
VrOwOwOwOwOwOwOwOwOwqyeQWAOnqyNTVpQPFRbUVpWAqyHdwdqyOwOwOwOwOwOwOwOwVr
VrOwOwOwOwOwOwOwOwOwqyiuyPUHCLWAwDHnmQORmQXEYYmKCuqyOwOwOwOwOwOwOwOwVr
VrOwOwOwOwOwOwOwOwOwffWAudGoCLFRQmbUApjMwIWLqyffffqyOwOwOwOwOwOwOwOwVr
VrOwOwOwOwOwOwOwOwOwqyhEQxnXthXEgPKZdSFZSqmoqyOwOwOwOwOwOwOwOwOwOwOwVr
VrOwOwOwOwOwOwOwOwqyqyqyqyffqyffffczqyBjBjBjqyqyOwOwOwOwOwOwOwOwOwOwVr
VrOwOwOwOwOwOwOwqyRgEVwtqyqRrGegAibVVoWAFRQmFRWAqyOwOwOwOwOwOwOwOwOwVr
VrOwOwOwOwOwOwOwffovSUPLqyGJtKWAbUOwOwOwyHOwOwOwOwOwOwOwOwOwOwOwOwOwVr
VrOwOwOwOwOwOwOwqyPLiqgPYYvFgPvFqEOwgCodOwyHOwOwGeOwyHOwOwOwOwOwOwOwVr
VrOwOwOwOwOwOwOwOwqyBjqyIQffQmFRPLyHOwOwOwOwodOwOwOwOwOwOwOwOwGeOwOwVr
VrOwOwOwOwOwOwOwOwOwOwOwqyIQWAPLWAOwOwGeOwyHOwOwOwOwOwOwOwOwOwOwOwOwVr
VrOwOwOwOwOwOwOwOwOwOwOwOwffmwmwWAOwOwodOwOwodOwOwyHOwOwodOwOwyHOwOwVr
VrOwOwOwOwOwOwOwOwOwOwOwOwIQYwYwVpOwOwyHOwOwOwOwodOwOwOwOwOwGeOwOwOwVr
VrOwOwOwOwOwOwOwOwOwOwOwOwOwOwOwOwOwOwOwOwOwOwOwOwOwOwGeOwOwOwOwOwOwVr
VrVrVrVrVrVrVrVrVrVrVrVrVrVrVrVrVrVrVrVrVrVrVrVrVrVrVrVrVrVrVrVrVrVrVr
"}
